1111111111111111111111111111111111111111
1000CCC000000000000000000000000001111111
10000000000000000E0000000CC0000001111111
1000000000111111111111111111111111111111
1000000000000000000000000000000001111111
1000011110001110000111000000000001111111
1111110CC1110CC01110CC111111000011111111
1000000000000000000000000000000001111111
1010P10010010010010010010010010011111111
1111111111111111111111111111111111111111
