11111
1C1E1
10001
1P101
11111
