11111
1C1E1
10101
1P001
11111
